Map Yay
20
20
12 12 12 12 12 12 12 12 12 12 12 12 12 12 12 12 12 12 12 12 
12 12 12 12 12 12 12 12 12 12 12 12 12 12 12 12 12 12 12 12 
12 12 12 12 12 12 12 12 12 12 12 12 12 12 12 12 12 12 12 12 
9  7  8  6  6  6  8  6  9  6  7  8  6  9  7  6  8  9  7  8  
2  3  3  3  5  2  3  3  3  5  2  3  4  4  5  2  4  4  3  5  
18 19 16 18 17 17 16 19 16 17 17 19 17 18 16 18 17 16 19 19 
19 18 15 18 13 16 13 18 14 14 18 12 17 14 19 14 16 12 17 18 
17 12 14 15 15 15 15 13 13 15 12 12 13 15 15 15 15 12 13 19 
17 19 12 13 13 12 12 12 14 12 15 15 15 15 14 12 12 14 17 16 
19 15 14 12 12 12 13 13 12 14 15 15 12 12 14 14 14 15 14 19 
18 19 15 15 15 12 13 12 12 14 15 12 12 13 12 12 15 15 16 18 
19 12 15 15 15 12 12 12 13 13 15 15 15 15 15 15 12 15 15 18 
18 16 14 14 12 13 15 15 15 12 15 15 15 12 15 12 13 13 16 19 
16 13 13 15 12 14 15 12 15 15 12 15 15 12 13 15 13 15 15 17 
19 16 15 15 12 14 15 13 15 12 13 15 15 12 14 12 12 12 18 17 
17 12 15 15 13 15 15 13 15 15 12 15 15 15 14 14 15 15 19 18 
17 19 15 14 12 15 13 12 27 29 14 12 15 15 13 13 15 13 18 18 
16 14 14 15 15 15 13 14 30 32 14 13 15 15 15 14 15 12 15 16 
16 18 12 16 12 17 15 18 30 32 19 15 18 12 17 14 18 15 19 17 
18 18 16 19 16 16 18 18 30 32 17 17 16 18 16 19 16 16 18 16 
