Map Yay
20
20
12 12 12 12 12 12 12 12 12 12 12 12 12 12 12 12 12 12 12 12 
12 12 12 12 12 12 12 12 12 12 12 12 12 12 12 12 12 12 12 12 
12 12 12 12 12 12 12 12 12 12 12 12 12 12 12 12 12 12 12 12 
9  7  8  6  6  6  8  6  9  6  7  8  6  9  7  6  8  9  7  8  
2  3  3  3  5  2  3  3  3  5  2  3  4  4  5  2  4  4  3  5  
23 23 21 23 20 23 20 22 23 22 20 23 23 22 21 23 22 23 20 22 
21 21 15 22 13 22 13 23 14 14 23 12 22 14 23 14 20 12 23 20 
22 12 14 15 15 15 15 13 13 15 12 12 13 15 15 15 15 12 13 22 
21 23 12 13 13 12 12 12 14 12 15 15 15 15 14 12 12 14 21 23 
21 15 14 12 12 12 13 13 12 14 15 15 12 12 14 14 14 15 14 22 
23 21 15 15 15 12 13 12 12 14 15 12 12 13 12 12 15 15 20 23 
22 12 15 15 15 12 12 12 13 13 15 15 15 15 15 15 12 15 15 22 
23 23 14 14 12 13 15 15 15 12 15 15 15 12 15 12 13 13 23 23 
20 13 13 15 12 14 15 12 15 15 12 15 15 12 13 15 13 15 15 21 
22 22 15 15 12 14 15 13 15 12 13 15 15 12 14 12 12 12 22 23 
22 12 15 15 13 15 15 13 15 15 12 15 15 15 14 14 15 15 15 22 
23 20 15 14 12 15 13 12 27 29 14 12 15 15 13 13 15 13 20 23 
22 14 14 15 15 15 13 14 30 32 14 13 15 15 15 14 15 12 15 23 
21 23 12 21 12 22 15 23 30 32 20 15 23 12 20 14 23 15 20 20 
21 22 22 23 20 21 20 22 30 32 21 23 22 22 20 23 20 21 23 23 
