Map Yay
20
20
11 11 11 11 11 11 11 11 11 11 11 11 11 11 11 11 11 11 11 11 
11 11 11 11 11 11 11 11 11 11 11 11 11 11 11 11 11 11 11 11 
11 11 11 11 11 11 11 11 11 11 11 11 11 11 11 11 11 11 11 11 
9  7  8  6  6  6  8  6  9  6  7  8  6  9  7  6  8  9  7  11 
1  2  3  3  5  2  3  3  5  2  3  3  5  2  3  3  5  2  5  1  
17 18 15 17 16 16 15 18 15 16 16 18 16 17 15 17 16 15 18 18 
18 17 14 17 12 15 12 17 13 13 17 11 16 13 18 13 15 11 16 17 
16 11 13 14 14 14 14 12 12 14 11 11 12 14 14 14 14 11 12 18 
16 18 11 12 12 11 11 11 13 11 14 14 14 14 13 11 11 13 16 15 
18 14 13 11 11 11 12 12 11 13 14 14 11 11 13 13 13 14 13 18 
17 18 14 14 14 11 12 11 11 13 14 11 11 12 11 11 14 14 15 17 
18 11 14 14 14 11 11 11 12 12 14 14 14 14 14 14 11 14 14 17 
17 15 13 13 11 12 14 14 14 11 14 14 14 11 14 11 12 12 15 18 
15 12 12 14 11 13 14 11 14 14 11 14 14 11 12 14 12 14 14 16 
18 15 14 14 11 13 14 12 14 11 12 14 14 11 13 11 11 11 17 16 
16 11 14 14 12 14 14 12 14 14 11 14 14 14 13 13 14 14 18 17 
16 18 14 13 11 14 12 11 26 28 13 11 14 14 12 12 14 12 17 17 
15 13 13 14 14 14 12 13 29 31 13 12 14 14 14 13 14 11 14 15 
15 17 11 15 11 16 14 17 29 31 18 14 17 11 16 13 17 14 18 16 
17 17 15 18 15 15 17 17 29 31 16 16 15 17 15 18 15 15 17 15 
