Decor Yay (xpos, ypos, tileID, layer)
4
21
180 120 77  1   
260 120 78  1   
340 120 78  1   
340 200 78  1   
140 100 62  1   
140 120 66  1   
140 140 66  1   
140 160 66  1   
140 180 66  1   
60  360 66  1   
60  380 70  1   
140 200 66  1   
60  340 66  1   
60  320 66  1   
140 280 73  1   
140 260 66  1   
140 240 66  1   
120 280 63  1   
120 300 73  1   
140 220 66  1   
60  300 63  1   
