Map Yay
25
28
12 12 12 12 12 12 12 12 12 12 12 12 12 12 12 12 12 12 12 12 12 12 12 12 12 
12 12 12 12 12 12 12 12 12 12 12 12 12 12 12 12 12 12 12 12 12 12 12 12 12 
12 12 12 12 12 12 12 12 12 12 12 12 12 12 12 12 12 12 12 12 12 12 12 12 12 
12 12 12 12 12 12 12 12 12 12 12 12 12 12 12 12 12 12 12 12 12 12 12 12 12 
12 12 12 12 12 12 12 12 12 12 12 12 12 12 12 12 12 12 12 12 12 12 12 12 12 
12 12 12 12 12 12 12 12 12 12 12 12 12 12 12 12 12 12 12 12 12 12 12 12 12 
12 12 12 12 12 12 12 12 12 12 12 12 12 12 12 12 12 12 12 12 12 12 12 12 12 
12 12 12 12 12 12 12 12 12 12 12 12 12 12 12 12 12 12 12 12 12 12 12 12 12 
12 12 12 12 12 12 12 12 12 12 12 12 12 12 12 12 12 12 12 12 12 12 12 12 12 
12 12 12 12 12 12 12 12 12 12 12 12 12 12 12 12 12 12 12 12 12 12 12 12 12 
81 82 82 82 12 20 12 20 12 20 12 12 12 12 12 20 12 20 12 20 12 82 82 82 83 
20 12 20 12 20 12 20 12 20 12 12 12 12 12 12 12 20 12 20 12 20 12 20 12 20 
12 20 12 20 12 20 12 20 12 20 12 12 12 12 12 20 12 20 12 20 12 20 12 20 12 
20 12 20 12 20 12 20 12 20 12 12 12 12 12 12 12 20 12 20 12 20 12 20 12 20 
12 20 12 20 12 20 12 20 12 20 12 12 12 12 12 20 12 20 12 20 12 20 12 20 12 
20 12 20 12 20 12 20 12 20 12 20 30 31 32 20 12 20 12 20 12 20 12 20 12 20 
12 20 12 20 12 20 12 20 12 20 12 30 31 32 12 20 12 20 12 20 12 20 12 20 12 
20 12 20 12 20 12 20 12 20 12 20 30 31 32 20 12 20 12 20 12 20 12 20 12 20 
61 61 61 61 61 61 61 61 61 61 61 62 31 60 61 61 61 61 61 61 61 61 61 61 61 
31 31 31 31 31 31 31 31 31 31 31 31 31 31 31 31 31 31 31 31 31 31 31 31 31 
55 55 55 55 55 55 55 55 55 55 55 56 31 54 55 55 55 55 55 55 55 55 55 55 55 
20 12 20 12 20 12 20 12 20 12 20 59 31 57 20 12 20 12 20 12 20 12 20 12 20 
12 20 12 20 12 20 12 20 12 20 12 59 31 57 12 20 12 20 12 20 12 20 12 20 12 
20 12 20 12 20 12 20 12 20 12 20 59 31 57 20 12 20 12 20 12 20 12 20 12 20 
12 20 12 20 12 20 12 20 12 20 12 59 31 57 12 20 12 20 12 20 12 20 12 20 12 
20 12 20 12 20 12 20 12 20 12 20 30 31 32 20 12 20 12 20 12 20 12 20 12 20 
12 20 12 20 12 20 12 20 12 20 12 30 31 32 12 20 12 20 12 20 12 20 12 20 12 
20 12 20 12 20 12 20 12 20 12 20 30 31 32 20 12 20 12 20 12 20 12 20 12 20 
